+><---+---+--+--+--+---+--+---+
|         |              |    ]
+  +-+-+  +  +--+--+--+--+  +++
|  ||  |     |        |  |  |||
+  ++  +  +--+  +--+  +  +  +++
|  ||  -        |  |  |  |    |
+--++  +--+--+  +  +  +  +--  +
|  )|           |  |  |       |
+  ++  +  +--+--+  +  +-+-++  |
|      |        |  |      ||  -
+--+---+  +  +  +  +-+-+  ++  -
|         |  |            ||  -
+--+---+--+  +-+  +--+--+-++  -
|              |  |           -
+  +--+--+--+  +  +--+  +--   +
|  [|          |        (--   |
+--+--+--+--+--+--+-+--+--+---+