+<>--+--+--+--+--+--+--+--+--+--+--+--+--+--+--+--+--+--+-
|                 |        |  |     |  |                 |
+  +--+  +--+--+--+  +  +  +  +--+  +--+--+--+--+  +  +  +
|     |  |     |        |  |        |  |     |        |  |
+  +  +  +  +--+  +--+  +--+  +--+  +  +--+--+--+  +  +  +
|     |  |  |  |        |     |     |  |  |        |  |  |
+  +  +  +  +  +--+--+  +--+--+  +  +--+  +--+  +  +  +  +
|  |  |  |     |  |  |        |     |  |        |  |  |  |
+  +  +  +  +--+  +  +--+--+  +  +  +  +--+  +  +  +--+  +
|     |        |  |     |     |  |  |     |  |        |  |
+  +  +--+--+  +  +  +  +  +--+  +  +  +--+--+  +--+--+  +
|  |     |     |  |  |        |  |     |  |  |     |  |  |
+--+  +  +--+--+  +  +--+  +--+  +  +--+  +  +--+--+  +--+
|  |  |  |  |  |     |     |  |  |  |     |  |     |  |  |
+--+--+  +--+  +  +  +--+--+  +  +--+  +  +--+  +--+--+  +
|     |     |     |  |        |  |  |  |     |     |  |  |
+  +  +--+--+  +--+  +--+--+--+  +  +  +  +--+--+  +  +  +
|  |  |  |        |  |  |        |  |  |     |     |  |  |
+--+  +  +  +  +  +  +--+--+--+  +  +  +--+--+  +  +--+  +
|     |  |  |     |  |        |  |  |  |     |  |     |  |
+  +--+  +--+  +  +  +  +--+--+  +  +  +--+  +--+--+--+--+
|     |        |  |  |     |  |  |  |  |     |     |     |
+  +--+  +--+  +  +  +--+--+--+  +  +  +--+  +--+--+  +  +
|        |     |     |     |     |  |     |  |     |  |  |
+--+--+  +  +--+--+--+--+--+  +--+  +  +  +  +--+--+  +  +
|        |     |     |     |     |  |     |  |  |     |  |
+--+--+--+---)-+--+--+--+--+---(-+<>+--+--+--+--+--+--+--+
