+><---+-----+--+--+--+--+--+--+
|           |                 )
+  +--+--+  +  +--+--+--+  +  +
|  |     |     |        |  |  |
+  +  +  +--+--+  +--+  +  +  +
[  |  -        |  |  |        |
+  +  +--+--+  +  +  +  +--+--+
|  |           |  |  |        |
+  +  +  +--+--+  +  +--+--+  ]
|     |        |  |        |  -
+--+--+  +  +  +  +--+--+  +  -
|        |  |              |  -
+--+--+--+  +  +  +  +--+--+  |
|              |  |           -
+  +--+--+--+  +  +--+   +    +
(  |           |         |    |
+--+--+--+--+--+--+--+--+--+><+