+..---+-----+--+--+--+--+--+--+
|           |                 |
+  +--+--+  +  +--+--+--+  +  +
|  |     |     |        |  |  |
+  +  +  +--+--+  +--+  +  +  +
|  |  |        |  |  |        |
+  +  +--+--+  +  +  +  +--+--+
|  |           |  |  |        |
+  +  +  +--+--+  +  +--+--+  +
|     |        |  |        |  |
+--+--+  +  +  +  +--+--+  +  +
|        |  |  |           |  |
+--+--+--+  +  +  +  +--+--+  +
|              |  |           |
+  +--+--+--+  +  +--+--+  +  +
|  |           |           |  |
+--+--+--+--+--+--+--+--+--+..+