+-><--+-----+--+--+--+--+--+--+
|           |                 |
+  +--+--+  +  +--+--+--+  +  +
|  |     |     |        |  |  |
+  +  +  +--+--+  +--+  +  +  +
|  )  -        ]  |  |        |
+  +  +--+--+  +  +  +  +--+--+
|  |           |  |  |        |
+  +  +  +--+--+  +  +--+--+  [
|     |        |  |        |  -
+--+--+  +  +  +  +--+--+  +  -
|        |  |              |  -
+--+--+--+  +  +  +  +--+--+  (
|              |  |           -
+  +--+--+--+  +  +--+   +    +
|  |           |         |    |
+--+--+--+--+--+--+--+--+--+><+