+><---+-----+--+--+--+--+--+--+
|           |                 |
+  +--+--+  +  +--+--+--+  +  +
|  |     |     |        |  |  |
+  +  +  +--+--+  +--+  +  +  +
|  |  |        |  |  |        |
+  +  +--+--+  +  +  +  +--+--+
|  |           |  |  |        |
+  +  +  +--+--+  +  +--+--+  +
|     |        |  |        |  |
+--+--+  +  +  +  +--+--+  +  +
|        |  |              |  |
+--+--+--+  +  +  +  +--+--+  +
|              |  |           |
+  +--+--+--+  +  +--+   +    +
|  |           |         |    |
+--+--+--+--+--+--+--+--+--+><+