+><---+---+--+--+--+---+--+---+
|         |              |    ]
+  +-+-+  +  +--+--+--+  +  +++
|  ||  |     |        |  |  |||
+  ++  +--+--+  +--+  +  +  +++
|  ||  -        |  |  |  |    |
+--++  +--+--+  +  +  +  +--  +
|  )|           |  |  |       |
+  ++  +  +--+--+  +  +-+-++  |
|      |        |  |      ||  -
+--+---+  +  +  +  +-+-+  ++  -
|         |  |            ||  -
+--+---+--+  +-+  +--+--+-++  -
|              |  |           -
+  +--+--+--+  +  +--+  +--   +
|  [|          |        (--   |
+--+--+--+--+--+--+-+--+--+---+